
congested: tắc nghẽn
congestion: sự tắc nghẽn
congest:làm tắc nghẽn
consider:xem xét, cân nhắc
consideration: sự cân nhắc, sự suy xét
considerate:thận trọng, chu đáo
considerable: đáng kể, to tát
considerably:một cách đáng kể
control: điều khiển, kiểm soát
controller:người kiểm soát
controllable:có thể kiểm soát
controlled:được kiểm soát
convenient:thuận lợi, tiện lợi
inconvenient:bất tiện
convenience:sự tiện lợi
inconvenience: sự bất tiện
conveniently:một cách thuận lợi
inconveniently:một cách bất tiện
country:quốc gia
cross-country:xuyên quốc gia
create: tạo nên, tạo ra
creation: sự tạo ra
creative: sáng tạo
creativity: sức sáng tạo
creator:nhà sáng tạo
crow: đám đông, tụ tập
crowded: đông đúc
overcrowded: quá đông, quá tải
overcrowding:tình trạng quá đông đúc, chật chội
curious:tò mò
curiosity:sự tò mò
cycle:đạp xe, vòng, chu kỳ
cycling: hoạt động đạp xe, đua đạp xe
cyclic:tuần hoàn theo chu kỳ
cyclically:theo chu kỳ
danger:sự nguy hiểm
dangerous: nguy hiểm
dangerously:một cách nguy hiểm
endanger:gây nguy hiểm
endangered:có nguy cơ tuyệt chủng
decide:quyết định
decision:quyết định, phán xét
decided:rõ ràng, dễ nhận thấy
undecided:lưỡng lự, chưa đưa ra quyết định
decisive:quyết đoán
indecisive:do dự, thiếu quyết đoán
decidedly:một cách chắc chắn, rõ ràng


Spring: mùa xuân, bật ra, nhảy ra, không ngờ, vượt ngục

Offspring: con cháu, dòng dõi

Star: vì sao, ngôi sao, ngôi sao điện ảnh

Stardom: sự danh tiếng, sự nổi tiếng

Stressful: gây căng thẳng

Stress: sự căng thẳng

Stressed: bị căng thẳng

Strong: mạnh mẽ

Strength: sức mạnh, điểm mạnh

Strengthen: tăng cường

Strongly: mạnh, chắc chắn


Socialize: xã hội hóa

Socially: có tính chất xã hội

Solid: rắn, cứng, thể rắn, chất rắn

Solidify: làm vững chắc, làm rắn lại

Solidly: một cách kiên cố

Solidarity: tình đoàn kết, sự thống nhất

Solidity: sự vững chắc, kiên cố

Solidification: sự đặc lại, cứng cỏi

Spend: chi tiêu, dành thời gian

Expenditure: sự chi tiêu, sự tiêu dùng

Sudden: đột ngột

Suddenly: một cách đột ngột

Suddenness: sự đột ngột

Suit: hợp với, đáp ứng được, phù hợp với / bộ com-lê, bộ quần áo

Suited: phù hợp với

Unsuited: không phù hợp

Suitable: thích hợp

Unsuitable: không phù hợp, không thích hợp

Style: phong cách

Stylist: nhà tạo mẫu

Stylish: có phong cách

Stylistic: liên quan đến phong cách (của nghệ sĩ nào)

Stylishly: một cách cá tính, thời thượng

Stylistically: về phong cách

Stylized: được cách điệu

Success: sự thành công

Succeed: thành công

Successful: thành công

Unsuccessful: không thành công

Successfully: một cách thành công

Unsuccessfully: một cách không thành công

advance: tiến lên, tiến tới, tiến bộ, đề xuất, đưa ra, ứng trước, trả tiền
advise: khuyên bảo, thông báo cho ai đó
affair: việc, vấn đề, mối quan hệ lén lút
afford: đủ khả năng chi trả, cung cấp ai đó với cái gì
agenda: lịch trình cuộc họp, mục đích hoặc ý đồ
aggressive: hung hăng, quyết tâm
agree: đồng ý, giống với, trùng khớp với
appeal: kêu gọi, cầu khẩn, lôi kéo thu hút
application: đơn ứng tuyển, ứng dụng, sự chuyên cần